See	Female
Pei	Female
Stanton	Male
Diane	Female	
Wenona	Female
Nubia	Female
Carina	Female
Winston	Male
Robert	Male
Ronnie	Male
Erminia Female
Deandrea	Female
Wilburn	Male
Bertie	Female
Miki	Female
Alysa	Female
Shayne	Male
Shara	Female
Leonila	Female
Dimple	Female
Martin	Male
Boyd	Male
Ryann	Female
Lissette	Female
Sandasa	Female
Darrel	Male
Bob	Male
Viola	Female
Delisa	Female
Helena	Female
Ross	Male
Ligia	Female
Clemente	Male
Juliane	Female
Jimmy	Male
Cornelius	Male
Gracie	Female
Kiara	Female
Treena	Female
Coralee	Female
Jaunita	Female
Catherina	Female
Randolph	Male
Bebe	Female
Monserrate	Female
Hildegarde	Female
Rod	Male
Ramiro	Male
Eleanor	Female
Londa	Female